PSD95	Adapter
GAIP	Other
ABP1	Adapter
ARIP2	Adapter
CALRETICULIN	Other
GLYT1	Membrane
cIAP2	Other
COFILIN	Other
ANKYRIN	Other
RYR	Other
EEF2K	Ribosomes
PKB	Other
MNK1	Other
DYNEIN	Adapter
POTASSIUM	Other
GABARAP	Adapter
SYNTAXIN	Vesicles
SV2A	Vesicles
ADPRIBSYCYCLASE	Other
IGF1R	Other
KV42	Membrane
NWASP	Other
PSD93	Adapter
CAMKI	Other
CAMKK	Other
IKBA	Other
S40	Ribosomes
JIP	Adapter
COMPLEXIN	Vesicles
DREAM	Other
SNAP25	Vesicles
SHANK	Adapter
PKN	Other
RICS	Adapter
CAMKIV	Other
CAMKII	Other
PTEN	Other
JNK	Other
RASGRP3	Other
SYNTENIN	Adapter
CRIPT	Adapter
GAP43	Adapter
SSCAM	Adapter
ENKEPHALIN	Ligand
M2R	Membrane
MST3	Adapter
TAU	Other
NFM	Other
NFH	Other
mRNA	Ribosomes
PKCE	Other
ANANDAMIDE	Ligand
HCK	Other
COOL	Other
MERLIN	Adapter
tRNA	Ribosomes
NOPR	Membrane
CBL	Other
PERK	Other
CBP	Other
GIT1	Adapter
NASCENTCHAIN	Ribosomes
NOS	Other
DOK	Adapter
RALBP1	Other
S6	Adapter
RET	Membrane
XIAP	Other
EPAC	Other
NEUREXIN	Membrane
ADAPTIN	Adapter
FILAMIN	Other
Potassium	Other
PHAS	Ribosomes
PHAP	Other
CaMKI	Other
MARCKS	Adapter
EFA6	Other
DOC2	Vesicles
PI3K	Other
GELSOLIN	Other
BETAARRESTIN	Adapter
EIF5	Ribosomes
PP2C	Other
DOPAMINE	Ligand
LEF1	Other
APOLLON	Other
KIR21	Membrane
EPHRIN	Ligand
SS	Ligand
FIBRINOGEN	Ligand
STEP	Other
RIC	Adapter
SSTR1	Membrane
SSTR2	Membrane
KINESIN	Other
GLUTAMATE	Ligand
CDC42	Other
CAS	Adapter
EEF1A2	Ribosomes
EGFR	Membrane
BAX	Other
YOTIAO	Adapter
VAMP	Vesicles
BAD	Other
MITF	Other
BAK	Other
CAD	Other
KV41	Membrane
N41	Adapter
PDE1B	Other
PDE1A	Other
FIVEHT1AR	Membrane
PP2A	Other
ALPHACATENIN	Other
P53	Other
GRIP	Adapter
GRIT	Other
CLATHRIN	Vesicles
ABL	Other
SEC61P	Other
SYNAPTOBREVIN	Vesicles
CPI17	Other
TUBULIN	Other
SYNAPSIN	Vesicles
IKBB	Adapter
RSK	Other
MLK3	Other
D3R	Membrane
PDE1C	Other
NCK	Adapter
CEK1	Other
cADPR	Other
EEF2	Ribosomes
AXIN	Adapter
CAVEOLIN	Adapter
AP2	Adapter
AP1	Other
IP3	Other
ADENOSINE	Ligand
SIAH	Adapter
EGF	Ligand
FIVEHT2AR	Membrane
RAC	Other
PABP	Ribosomes
VAV	Other
RAL	Other
PAXILLIN	Adapter
RAI	Adapter
SURVIVIN	Adapter
BR1R	Membrane
CORTACTIN	Other
RAS	Other
RB	Other
FADD	Adapter
CAMKPASE	Other
SAPAP	Adapter
ROCK	Other
LAMINA	Other
INSULIN	Ligand
CSP	Adapter
APS	Adapter
C3G	Other
KAR	Membrane
ELK1	Other
RHO	Other
GRB10	Adapter
APC	Adapter
STAT	Other
GALPHAO	Other
GALPHAI	Other
KSR	Other
cAMP	Other
TBR1	Other
CAPRI	Other
GRP94	Other
GALPHAZ	Other
GALPHAQ	Other
GALPHAS	Other
PKR	Other
DAPK	Other
cIAP1	Other
PQCaCh	Membrane
MSK1	Other
PKC	Other
PKA	Other
PKG	Other
PKD	Other
CAIN	Other
PKI	Other
GSK3	Other
PDE5A	Other
CLIP170	Adapter
IGF1	Ligand
CSK	Other
DLK	Other
CERAMIDE	Other
GAT1	Membrane
SHC	Adapter
EIF4E	Adapter
PMCA	Membrane
EIF4G	Ribosomes
EIF4A	Ribosomes
YES	Other
EIF4B	Ribosomes
CIPP	Adapter
dATP	Other
LARG	Other
CREM	Other
DGK	Other
RADIXIN	Adapter
CREB	Other
FRIZZLED	Membrane
GKAP	Adapter
SYNDECAN	Membrane
L1	Membrane
M1R	Membrane
CALBRAIN	Other
PAFR	Membrane
P1433	Adapter
SEK	Other
pGC	Membrane
NEURABIN	Adapter
ARFGAP	Vesicles
GALPHA12	Other
GALPHA13	Other
PDI	Other
GALPHA11	Other
CALPAIN	Other
NEUROLIGIN	Membrane
SPAL	Other
RHOGEF	Other
IRS1	Adapter
IRS2	Adapter
PTPA	Other
FIBRONECTIN	Other
SYNAPTOTAGMIN	Vesicles
CDK5	Other
MAPK	Other
RABGDI	Other
ARNO	Other
ALPHA7NACHR	Membrane
RALGDS	Other
BIM	Other
CALMODULIN	Other
BIK	Other
BID	Other
CAMP	Other
FYN	Other
MEK3	Other
MEK2	Other
MEK1	Other
MEK7	Other
MEK6	Other
MEK4	Other
ERBB	Membrane
RACK	Adapter
BIP	Other
SNAPIN	Vesicles
CASPASE6	Other
CASPASE7	Other
CASPASE3	Other
AKAP15	Adapter
MLK	Other
CASPASE8	Other
CASPASE9	Other
VASP	Adapter
ICAD	Other
DOPR	Membrane
AKAP	Adapter
GLYR	Membrane
NRG	Ligand
MEKK4	Other
PRK2	Other
MTOR	Other
BCL2	Other
MUSK	Other
NEUROFIBROMIN	Other
CITRON	Other
PTP1B	Other
TUBERIN	Other
IQGAP	Other
SIVA1	Adapter
PTP1D	Other
MALS	Adapter
MGLUR5	Membrane
MGLUR7	Membrane
MGLUR1	Membrane
PAF	Ligand
TAMALIN	Adapter
PAK	Other
SMACDIABLO	Other
M4R	Membrane
CB2R	Membrane
RIN	Other
DYRK	Other
RIM	Adapter
STARGAZIN	Other
ENDOPHILIN	Vesicles
SAP97	Adapter
VRK1	Other
GEPHYRIN	Adapter
MYOSINV	Other
PRMT1	Other
NAIP	Other
P35611	Other
MDM2	Other
PDE4C	Other
RASGAP	Other
NIK	Other
PYK2	Other
BETA2AR	Membrane
ARFGEF	Vesicles
SYK	Other
NFKB	Other
bARK	Other
EPHB2	Membrane
DNAPK	Other
CARM1	Other
GAB1	Adapter
CRE	Other
SORCIN	Adapter
CRK	Adapter
NMDAR	Membrane
RABPHILIN	Vesicles
S6K	Other
PLCGAMMA	Other
ADDUCIN	Adapter
CASKIN	Vesicles
TIAM1	Other
PA	Other
WNT	Ligand
TCF	Other
HOMER	Adapter
MAP1A	Other
MAP1B	Other
ICA512	Membrane
INHIBITOR2	Other
LIMK	Other
S60	Ribosomes
SHPTP2	Other
MOR	Other
ANP	Ligand
LCK	Other
GABA	Ligand
BAG1	Adapter
VINCULIN	Other
ILK	Other
VDAC2	Other
FIVEHT4R	Membrane
RAF1	Other
STAT5	Other
SYNGAP	Other
STAT1	Other
PDE3A	Other
AMISYN	Vesicles
CASK	Other
PDE3B	Other
P38	Other
SPROUTY	Adapter
SAM68	Adapter
CHLORIDE	Other
PLCBETA	Other
FIVEHT1CR	Membrane
SYNTROPHIN	Adapter
SRC	Other
cAMPGEFII	Other
MUNC13	Vesicles
SPINOPHILIN	Other
SRE	Other
MUNC18	Vesicles
MYOSIN	Other
NTYPECA	Membrane
CGMP	Other
D1R	Membrane
PLD	Adapter
ERBIN	Adapter
PDE4A	Other
PDE4B	Other
RHEB	Adapter
PDE4D	Other
MKP1	Other
EIF2	Ribosomes
EIF3	Ribosomes
CHAPSYN110	Adapter
MKP5	Other
MAP2	Other
CALCIUM	Other
KIR23	Membrane
MOPR	Membrane
PIN1	Other
ALPHA1AR	Membrane
RASGRP	Other
EIF1A	Ribosomes
RAP1GAP	Other
I1	Other
FAS	Membrane
NHERF	Adapter
GBETAGAMMA	Other
RGS4	Other
FAK	Other
SOS	Other
RGS2	Other
RASGRF	Other
MBP	Other
VILIP	Adapter
cGMP	Other
DCP1	Ribosomes
CALCINEURIN	Other
IR	Membrane
PP1	Other
SRP54	Adapter
PP5	Other
DNAJ	Other
NFAT	Other
TALIN	Other
CB1R	Membrane
ARP23	Other
RAP2	Other
RAP1	Other
PDK1	Other
ARF	Vesicles
DARPP32	Other
SYNAPTOPHYSIN	Vesicles
JAK	Other
RAB3	Vesicles
NRCAM	Membrane
SPECTRIN	Other
REELIN	Ligand
MEF2	Other
PARP	Other
BDNF	Ligand
DRE	Other
GIRK	Membrane
GLYCINE	Ligand
SODIUM	Other
FLIP	Other
SEROTONIN	Ligand
LYN	Other
ZAP70	Other
SEC63P	Adapter
AMPHIPHYSIN	Adapter
NT4	Ligand
MEKK1	Other
MEKK3	Other
MEKK2	Other
bRAF	Other
IP6K2	Other
SRPR	Other
FORKHEAD	Other
GRB2	Adapter
PAR2	Membrane
PAR1	Adapter
PIP5K	Other
ARH2	Adapter
PDGF	Ligand
MP1	Adapter
TRYPSIN	Other
MAPKAPK2	Other
DYNAMIN	Vesicles
THC	Ligand
BCLXL	Other
CRMP2	Other
BAP31	Adapter
TRKB	Membrane
TRKA	Membrane
PROFILIN	Other
LTYPECA	Membrane
TRE	Other
GABABR	Membrane
ACTIN	Other
CAMPGEFII	Other
AMPAR	Membrane
IP3R	Other
MYOSINPPASE	Other
HIPPOCALCIN	Adapter
LRP	Membrane
TFIIB	Other
TFIID	Other
KIR41	Membrane
PRESENILIN	Membrane
KV11	Membrane
KV12	Membrane
ACH	Ligand
KV14	Membrane
NGF	Ligand
NAKED	Other
CHOLESTEROL	Membrane
KOPR	Membrane
EZRIN	Other
ALPHA2AR	Membrane
NO	Other
D2R	Membrane
REPS1	Adapter
NE	Ligand
NCADHERIN	Membrane
FASL	Ligand
GRAB	Other
SHP1	Other
APAF1	Adapter
SAP102	Adapter
PIP3	Other
PIP2	Other
INTEGRIN	Membrane
COLLAGEN	Other
FER	Other
CYTOCHROMEC	Other
MINT	Vesicles
LEF	Other
FRAT2	Adapter
RIN1	Other
PICK1	Adapter
PDZGEF	Other
DENSIN	Adapter
AC2	Other
AC1	Other
AC5	Membrane
FOUREBP1	Other
GABAAR	Membrane
MLCK	Other
PCAF	Other
NCS1	Adapter
SRF	Other
ALPHAACTININ	Other
DAG	Other
PLA2	Other
PICCOLO	Adapter
DAP	Adapter
DISHEVELED	Adapter
SYNTAPHILIN	Vesicles
AA	Other
VITRONECTIN	Other
BRADYKININ	Ligand
A1R	Membrane
RTYPECA	Membrane
FKBP	Adapter
PDGFR	Membrane
A2AR	Membrane
BETACATENIN	Other
PDE2A	Other
FASCIN	Membrane
GDNF	Ligand
CALNEXIN	Other
ATF1	Other
ATF2	Other
